哔哩哔哩	bilibili	10
YouTube	youtube	10
Twitter	Twitter	10

bug	bug
lua	lua
Python	python
JavaScript	javaScript
Java	java
Cpp	cpp
Shell	shell
Bash	bash
Base64	base64
Zsh	zsh
Rust	rust
Haskell	haskell
Markdown	markdown
Org	org
OrgMode	OrgMode
Vim	vim
Emacs	emacs
Node	node
XHR	xhr
HTTP	http
Promise	promise
fetch	fetch
axios	axios
python	python
javascript	javascript
java	java
cpp	cpp
shell	shell
bash	bash
base64	base64
zsh	zsh
rust	rust
haskell	haskell
markdown	markdown
org	org
orgmode	orgmode
vim	vim
emacs	emacs
node	node
xhr	xhr
http	http
promise	promise

<(づ￣　³￣)>づ	yoyo
o<(*≧▽≦)>ツ	klxn
<(=╯′皿｀)╯ ┫:·'∵:.┻┻:·'.:┣∵·:. ┳┳☆	xmvo
┻━┻︵╰<(=‵Д′=)>╯︵┻━┻	xmvo
<(=╯‵Д′)╯""┻━┻☆))>○<)	xmvo
<(=┘￣Д￣)┘╧═╧	xmvo
<(=￣▽￣"=)>	hehe
<(=＞﹏＜=)>	mcmc
<( >﹏<。=)>	mc
<(=·ェ·=)>	mkmk
o<(=°ω°=)>0	mkmk
Σ<(=￣д￣=!)>	jyle
ヾ(^▽^*=)>	hfhk
Σ(゜д゜=!)>	vfjy
<(=╥﹏╥=)>	wzqu
(PД`q。=)>·。'゜	kuku
Σ<(=⊙▽⊙)"	aaaa
( ´_ゝ｀)	eeee
ヽ(`Д´)ﾉ	nule
Σ_(꒪ཀ꒪」∠)_	fetx
(╯°口°)╯(┴—┴	fexm
(┯_┯)	feku
(=・ω・=)	fedy
（￣▽￣）	feei
(｀・ω・´)	fedy
(〜￣△￣)〜	febd
눈_눈	fenk
→_→	fezo
←_←	feyb
_(:з」∠)_	orz

阿Q	aaq
NFO	nfo
NDS	nds
RIP	rip
SNK	snk
ABC	abc
POS	pos
ABT	abt
NBA	nba
Nan	nan
RIO	rio
N股	ngu
N卡	nka
SIM	sim
M码	mma
ACT	act
M记	mji
RGB	rgb
ZIP	zip
RAR	rar
AGP	agp
OCR	ocr
Oct	oct
WEB	web
OEM	oem
VHS	vhs
RAM	ram
M币	mbi
MVP	mvp
Alt	alt
PPT	ppt
MTV	mtv
AMD	amd
ETC	etc
Q仔	qzl
MSN	msn
APC	apc
SFC	sfc
APP	app
iOS	ios
S级	sji
Mrs	mrs
EVA	eva
EVD	evd
ASP	asp
ATM	atm
SEO	seo
SOS	sos
SDR	sdr
AVG	avg
AVI	avi
SQL	sql
Q我	qwo
OMG	omg
ONS	ons
SCI	sci
MIT	mit
Evo	evo
EXE	exe
OST	ost
A股	agu
SUV	suv
S股	sgu
OTC	otc
A级	aji
OTG	otg
O记	oji
R级	rji
A卡	aka
RTA	rta
WHO	who
RPG	rpg
A米	ami
PDA	pda
PDF	pdf
ROM	rom
PHP	php
Wii	wii
A区	aqu
E区	equ
WIN	win
PSP	psp
S码	sma
Mia	mia
PSV	psv
A组	azu
IME	ime
MBA	mba
BBC	bbc
FAQ	faq
P大	pda
TCL	tcl
L码	lma
LTE	lte
BIO	bio
WMA	wma
Ltd	ltd
THX	thx
BMW	bmw
BTW	btw
RMB	rmb
LOL	lol
BUG	bug
Q币	qbi
TLF	tlf
TMD	tmd
ZTE	zte
GPS	gps
IDE	ide
B哥	bge
B股	bgu
TVB	tvb
B级	bji
WPS	wps
IBM	ibm
B区	bqu
Les	les
FPE	fpe
TXT	txt
FPS	fps
B族	bzu
T大	tda
B组	bzu
CAD	cad
T区	tqu
LCD	lcd
CBA	cba
CBD	cbd
GDP	gdp
FTP	ftp
WTO	wto
LBS	lbs
F码	fma
CEO	ceo
T恤	txu
F区	fqu
CGI	cgi
UBI	ubi
GSM	gsm
H股	hgu
UFO	ufo
CND	cnd
K歌	kge
UGG	ugg
KTV	ktv
KOF	kof
CPA	cpa
CPU	cpu
CRT	crt
GBA	gba
GBK	gbk
CTO	cto
URL	url
KFC	kfc
USA	usa
USB	usb
GIF	gif
C级	cji
C区	cqu
GTR	gtr
P图	ptu
JSP	jsp
JPG	jpg
C组	czu
USD	usd
DDR	ddr
DHL	dhl
U币	ubi
Q吧	qba
DIY	diy
HIV	hiv
DNS	dns
G币	gbi
DOS	dos
Ive	ive
齐B	qib
DPS	dps
DTS	dts
VCD	vcd
VGA	vga
DVD	dvd
QAQ	qaq
VGS	vgs
ISP	isp
DVI	dvi
Yee	yee
Yui	yui
ISO	iso
D区	dqu
VIP	vip
D组	dzu
VOA	voa
VOD	vod
大S	das
EHQ	ehq
VPN	vpn
HTC	htc
NGC	ngc
NGO	ngo
SLG	slg
NMD	nmd
NOD	nod
NPC	npc
N个	nge
AC3	ac3
操B	ckb
M值	mvi
阿Sa	aasa
被T	bzt
M号	mhk
Q友	qyb
MP3	mp3
Q信	qxn
A班	abj
A版	abj
A杯	abz
Q版	qbj
A货	aho
S号	shk
G友	gyb
A君	ajp
A口	akb
A类	alz
老K	lkk
A盘	apj
Q秀	qxq
E盘	epj
C盘	cpj
P事	pui
D版	dbj
D杯	dbz
牛B	nqb
B类	blz
C肽	czo
D口	dkb
D盘	dpj
T台	ttl
加Q	jwq
牛A	nqa
维C	wzc
F盘	fpj
D座	dzo
好Q	hkq
维B	wzb
C座	czo
很Q	hfq
甲B	jwb
挂Q	gwq
E座	ezo
B座	bzo
Q号	qhk
H版	hbj
加v	jwv
傻X	uax
T人	trf
B杯	bbz
U盾	udp
N倍	nbz
N多	ndo
傻B	uab
维a	wza
N家	njw
骚B	skb
羣P	qpp
E文	ewf
B口	bkb
U盘	upj
B版	bbj
Q羣	qqp
OK啊	okaa
B班	bbj
Y蛋	ydj
OK哦	okoo
P民	pmn
C班	cbj
C杯	cbz
A座	azo
L号	lhk
P话	phw
P过	pgo
K金	kjn
维E	wze
QQ啊	qqaa
C口	ckb
PS2	ps2
C类	clz
C楼	clb
C罗	clo
甲A	jwa
牛X	nqx
B款	bkw
小Q	xwq
B型	bxy
小K	xwk
小C	xwc
Cbox	cbox
CCED	cced
我TM	wotm
CDMA	cdma
CD机	cdji
我QQ	woqq
CFPL	cfpl
CF卡	cfka
我OK	wook
CHOK	chok
CMCC	cmcc
CMOS	cmos
CNTV	cntv
CSOL	csol
她QQ	taqq
他QQ	taqq
Ctrl	ctrl
C调	cdw
C栋	cds
C网	cwh
C型	cxy
DMAX	dmax
Doin	doin
DOMO	domo
Doov	doov
DOWN	down
D调	ddw
D栋	dds
eBay	ebay
Elly	elly
你TM	nitm
你QQ	niqq
你OK	niok
ESPN	espn
Ezra	ezra
FIFA	fifa
FILA	fila
QQ币	qqbi
F团	ftw
F型	fxy
发QQ	faqq
发pp	fapp
短T	dwt
都OK	duok
大pp	dapp
Gozo	gozo
打pp	dapp
打CS	dacs
此ID	ciid
超Q	ikq
GPRS	gprs
G点	gdw
G团	gtw
不OK	buok
Haru	haru
HDMI	hdmi
HDTV	hdtv
TiMi	timi
HIFI	hifi
HITA	hita
Zelo	zelo
Y轴	yvb
YULI	yuli
Yuki	yuki
X轴	xvb
X线	xxw
XXOO	xxoo
XBOX	xbox
HTML	html
Xbox	xbox
Hulu	hulu
WWDC	wwdc
ICBC	icbc
WORD	word
IC卡	icka
ID卡	idka
IEEE	ieee
Ikan	ikan
IKEA	ikea
Ikki	ikki
iMac	imac
IMAX	imax
WLAN	wlan
IMEI	imei
IMSI	imsi
WiFi	wifi
WE吧	weba
iPad	ipad
V型	vxy
V领	vly
VVIP	vvip
iPod	ipod
IPSA	ipsa
IPTV	iptv
VOTO	voto
VIXX	vixx
IP卡	ipka
Vics	vics
ISDN	isdn
iSee	isee
VDSL	vdsl
IT业	itye
U型	uxy
QZZN	qzzn
QVOD	qvod
Jizz	jizz
JOJO	jojo
Kary	kary
Kass	kass
Kbps	kbps
Kenn	kenn
Kian	kian
Kimi	kimi
Koei	koei
KOEI	koei
Kone	kone
Kuma	kuma
KUSO	kuso
Uber	uber
K线	kxw
LaLa	lala
T型	txy
Letv	letv
Lexi	lexi
Limi	limi
TOUS	tous
TOTO	toto
TODO	todo
TODO	TODO
LOGO	logo
TF卡	tfka
Luka	luka
TERA	tera
Maya	maya
Tata	tata
MAYU	mayu
S型	sxy
MERS	mers
S键	sjw
Mido	mido
MiGo	migo
Miki	miki
Mima	mima
SVCD	svcd
SUKI	suki
MIUI	miui
ST股	stgu
Mixx	mixx
Miya	miya
SRPG	srpg
MOKA	moka
Soso	soso
Mook	mook
SONY	sony
MPEG	mpeg
MSDN	msdn
Sony	sony
MUJI	muji
Sohu	sohu
Nano	nano
Nars	nars
SOGO	sogo
Soga	soga
SoDu	sodu
Acer	acer
ADSL	adsl
SM卡	smka
AIDS	aids
Niko	niko
AIIB	aiib
AIYA	aiya
Alam	alam
NTFS	ntfs
PPTV	pptv
N遍	nbw
Siri	siri
APEC	apec
Apps	apps
ARPG	arpg
ASOS	asos
A等	adf
N年	nnw
A点	adw
A栋	ads
OAOA	oaoa
A段	adw
A卷	ajw
A款	akw
QQ里	qqli
A面	amw
A片	apw
OK吧	okba
OK的	okde
OK啦	okla
A屏	apy
A线	axw
SEGA	sega
OK吗	okma
OK嘛	okma
OK麽	okme
A型	axy
OK呀	okya
SD卡	sdka
BADA	bada
Etam	etam
BAKA	baka
Baru	baru
OPPO	oppo
PU皮	pupi
SAYA	saya
SaSa	sasa
SARS	sars
Bbox	bbox
BB机	bbji
Q点	qdw
SANA	sana
BIOS	bios
O型	oxy
Buka	buka
RWBY	rwby
RURU	ruru
P2P	p2
Pabo	pabo
B超	bik
小Y	xwy
QQ卡	qqka
Pchy	pchy
PC机	pcji
小S	xws
RoRo	roro
B点	bdw
B栋	bds
PE膜	pemo
B键	bjw
B卷	bjw
PIKO	piko
Roem	roem
PLMM	plmm
RMVB	rmvb
NICI	nici
最IN	zvin
DJ版	djbj
AV国	avgo
加QQ	jwqq
Hi好	hihk
要QQ	ykqq
MM好	mmhk
MM们	mmmf
D证	dvf
挂QQ	gwqq
ID号	idhk
上Q	uhq
JM们	jmmf
很OK	hfok
有QQ	ybqq
没QQ	mzqq
QQ羣	qqqp
在QQ	zlqq
是OK	uiok
QQ秀	qqxq
Q宠	qis
只OK	viok
LV包	lvbk
阿Q	aaq
帅T	uwt
玩CF	wjcf
PP粉	ppff
PP岛	ppdk
QQ	QQ
阿sir	aasir
就OK	jqok
贴pp	txpp
哦lol	oolol
X光	xgw
玩CS	wjcs
拍MV	plmv
玩QQ	wjqq
长T	iht
AK47	ak4
看QQ	kjqq
A证	avf
Q上	quh
来PK	llpk
PC版	pcbj
TV版	tvbj
Q传	qiw
唱K	ihk
pH值	phvi
PK版	pkbj
A和B	aheb
QQ号	qqhk
PK赛	pksl
泡MM	pkmm
IT界	itjx
AA制	aavi
新QQ	xnqq
PN结	pnjx
下QQ	xwqq
穷B	qsb
Linux	linux
LINUX	linux
TOPIK	topik
LMFAO	lmfao
Tmall	tmall
聊QQ	lwqq
but你	butni
用PS	ysps
用QQ	ysqq
TimeZ	timez
TiAmo	tiamo
真TM	vftm
Etude	etude
Lumia	lumia
你lol	nilol
装B	vwb
Tenda	tenda
Tegra	tegra
Mandy	mandy
BEELY	beely
Zakka	zakka
ZAKER	zaker
帮LZ	bhlz
QQ名	qqmy
Badoo	badoo
MBLAQ	mblaq
Tablo	tablo
你TMD	nitmd
Messi	messi
EMAIL	email
PRICH	prich
Prezi	prezi
封ID	ffid
gay蜜	gaymi
封IP	ffip
Elina	elina
Minoz	minoz
H股	hgu
A股	agu
Easou	easou
Prada	prada
Eason	eason
Q币	qbi
VIP卡	vipka
Furla	furla
AV线	avxw
MMC卡	mmcka
Avril	avril
SPA机	spaji
Viber	viber
ATM机	atmji
PP棉	ppmw
换IP	hwip
ASCII	ascii
ANSYS	ansys
DVD机	dvdji
Amani	amani
Alisa	alisa
MySQL	mysql
Alina	alina
POS机	posji
ACOME	acome
AcFun	acfun
AB型	abxy
胖MM	phmm
NAVER	naver
AB胶	abjw
Sogou	sogou
DUEBA	dueba
AAA级	aaaji
Neway	neway
CUCCI	cucci
YONEX	yonex
Diors	diors
Shift	shift
Cuban	cuban
刷QQ	uwqq
iFile	ifile
Holle	holle
Shero	shero
OK镜	okjy
换QQ	hwqq
OK了	oklw
Kimmy	kimmy
Ulike	ulike
等QQ	dfqq
Nokia	nokia
提bug	tibug
Ukiss	ukiss
QQ聊	qqlw
Konka	konka
Dicos	dicos
Baidu	baidu
Zynga	zynga
UV镜	uvjy
ooooO	ooooo
Ooooo	ooooo
QQ堂	qqth
Q币卡	qbika
Cydia	cydia
K歌	kge
CMWAP	cmwap
UCDOS	ucdos
CMNET	cmnet
Choco	choco
我lol	wolol
SANYO	sanyo
Sanyo	sanyo
QQ说	qquo
Gucci	gucci
去KTV	quktv
Sammi	sammi
T恤	txu
CF点	cfdw
第N次	dinci
SIM卡	simka
我OUT	woout
CDKEY	cdkey
Casio	casio
Intel	intel
小DD	xwdd
登QQ	dfqq
PC端	pcdw
小JJ	xwjj
小MM	xwmm
Lenka	lenka
Skype	skype
小pp	xwpp
PE管	pegw
刷QB	uwqb
发EMS	faems
TVout	tvout
你OUT	niout
B股	bgu
PIN码	pinma
Pixiv	pixiv
JUSCO	jusco
Zippo	zippo
USANA	usana
Lilin	lilin
ID照	idvk
PLORY	plory
FESCO	fesco
Gmail	gmail
李sir	lisir
u模式	umoui
U盘	upj
U盘里	upjli
v模式	vmoui
WAN口	wankb
X刀	xdk
白T恤	bltxu
出bug	iubug
传pp	iwpp
改bug	glbug
好lol	hklol
好low	hklow
好man	hkman
很man	hfman
加我Q	jwwoq
来lol	lllol
刘sir	lqsir
哦shit	ooshit
A计划	ajihw
A盘	apj
上QQ	uhqq
上YY	uhyy
帅GG	uwgg
A字裙	aziqp
玩DNF	wjdnf
玩LOL	wjlol
吓cry	xwcry
修bug	xqbug
在KTV	zlktv
做PPT	zoppt
B级车	bjiie
B盘	bpj
C盘	cpj
C语言	cyuyj
DVD版	dvdbj
D盘	dpj
EXO饭	exofj
E盘	epj
FAT16	fat1
FAT32	fat3
F盘	fpj
G盘	gpj
H盘	hpj
H游戏	hybxi
iOS	ios
i美股	imzgu
i模式	imoui
I盘	ipj
J盘	jpj
K粉	kff
K金	kjn
low货	lowho
May姐	mayjx
nice啊	niceaa
OEM版	oembj
PCB板	pcbbj
PK场	pkih
3Dmax	3dma
QQ上	qquh
Q拍乐	qplle
USB口	usbkb
U盾	udp
MOS管	mosgw
Xoxoxo	xoxoxo
iTunes	itunes
iTouch	itouch
Adidas	adidas
LOFTER	lofter
USB线	usbxw
Amanat	amanat
企业QQ	qiyeqq
TomBoy	tomboy
e卡通	ekats
HTCOne	htcone
ARASHI	arashi
Armani	armani
Xperia	xperia
dota吧	dotaba
打kiss	dakiss
A出口	aiukb
A片	apw
E路航	eluhh
E时代	euidl
客服QQ	kefuqq
客服MM	kefumm
Hitomi	hitomi
BB霜	bbuw
E世界	euijx
BeDook	bedook
Lenovo	lenovo
DVD	dvd
挤我QQ	jiwoqq
D大调	ddadw
QQ皮肤	qqpifu
E邮宝	eybbk
Typany	typany
iPhone	iphone
你的QQ	nideqq
LED屏	ledpy
LED灯	leddf
Lavida	lavida
T台秀	ttlxq
Eminem	eminem
VMware	vmware
QQ客服	qqkefu
QQ业务	qqyewu
QQ密码	qqmima
Sophia	sophia
K线图	kxwtu
T恤衫	txuuj
你high	nihigh
VOBSUB	vobsub
你call	nicall
K歌王	kgewh
卡拉OK	kalaok
那个QQ	nageqq
X档桉	xdhan
K歌	kge
iWatch	iwatch
QQGame	qqgame
KONAMI	konami
PVC管	pvcgw
UNIQLO	uniqlo
high歌	highge
Keroro	keroro
Kazaky	kazaky
Viscap	viscap
USB	usb
JUNIEL	juniel
fx组合	fxzuhe
V字领	vzily
Rainie	rainie
V字形	vzixy
Warkey	warkey
WeChat	wechat
GATSBY	gatsby
rime	rime
gay片	gaypw
发我QQ	fawoqq
发你QQ	faniqq
Poppin	poppin
Google	google
大V领	davly
GOSICK	gosick
Gougou	gougou
大boss	daboss
大baby	dababy
WiFi卡	wifika
打game	dagame
out了	outlw
打dota	dadota
打boss	daboss
最牛B	zvnqb
自high	zihigh
Bieber	bieber
真TMD	vftmd
Omegle	omegle
SD娃娃	sdwawa
OK的啦	okdela
OFFICE	office
G点	gdw
SHINee	shinee
不high	buhigh
N多人	ndorf
n次方	ncifh
SISTAR	sistar
blue的	bluede
不care	bucare
B超	bik
B出口	biukb
Snidel	snidel
call我	callwo
CAPCOM	capcom
午夜DJ	wuyedj
我都OK	woduok
我的QQ	wodeqq
CC霜	ccuw
CELINE	celine
ChaCha	chacha
Hellen	hellen
Spyair	spyair
MOLANG	molang
iCloud	icloud
CNBlue	cnblue
Stephy	stephy
Stussy	stussy
Missha	missha
Misaki	misaki
Sweety	sweety
他的QQ	tadeqq
把我QQ	bawoqq
S曲线	squxw
iBooks	ibooks
刷Q币	uwqbi
Taobao	taobao
Yumiko	yumiko
MATLAB	matlab
DJ舞曲	djwuqu
Telnet	telnet
把他QQ	bataqq
HUAWEI	huawei
DNA	dna
日K线	rikxw
lol了	lollw
PK一下	pkyixw
D罩杯	dvkbz
你在QQ	nizlqq
你QQ号	niqqhk
PC游戏	pcybxi
QQ羣里	qqqpli
T型台	txytl
K金	kjn
O型血	oxyxt
O型腿	oxytv
打开QQ	daklqq
嘿girl	hzgirl
那就OK	najqok
K粉	kff
魅族MX	zozumx
没WiFi	mzwifi
没root	mzroot
做B超	zobik
没feel	mzfeel
龙珠Z	lsvuz
谘询QQ	zixpqq
荔枝FM	livifm
QQ西游	qqxiyb
hold姐	holdjx
SD敢达	sdgjda
这个QQ	vegeqq
QQ信息	qqxnxi
吹牛B	ivnqb
出core	iucore
充Q币	isqbi
hold住	holdvu
X光	xgw
开WiFi	klwifi
QQ炫舞	qqzowu
G硬盘	gyypj
QQ音速	qqynsu
这个ID	vegeid
QQ音乐	qqynle
有WiFi	ybwifi
X光机	xgwji
IT技术	itjiuu
high好	highhk
有feel	ybfeel
QQ阅读	qqytdu
hi靓女	hizonv
B超单	bikdj
IQ博士	iqboui
小P孩	xwphl
B型血	bxyxt
B罩杯	bvkbz
开BOSS	klboss
QQ直播	qqvibo
QQ主题	qqvuti
IP卡	ipka
我在QQ	wozlqq
我下QQ	woxwqq
X射线	xuexw
笨nana	bfnana
就OK啦	jqokla
VI设计	viueji
QQ分组	qqffzu
sorry啊	sorryaa
hi美女	himznv
加我QQ	jwwoqq
加你QQ	jwniqq
Hi妹子	himzzi
维A酸	wzasw
QQ部落	qqbulo
摆pose	blpose
百度Hi	blduhi
IP地址	ipdivi
很nice	hfnice
iPod	ipod
很high	hfhigh
CoCo姐	cocojx
PP租车	ppzuie
QQ游戏	qqybxi
玩high	wjhigh
玩game	wjgame
玩dota	wjdota
好high	hkhigh
求solo	qqsolo
AC米兰	acmilj
偷WiFi	tbwifi
太high	tlhigh
Lisa姐	lisajx
随E行	svexy
APEC蓝	apeclj
QQ号码	qqhkma
AV女优	avnvyb
iPad	ipad
各位MM	gewzmm
A型血	axyxt
A罩杯	avkbz
C罩杯	cvkbz
奇瑞QQ	qirvqq
Lily姐	lilyjx
YY语音	yyyuyn
Hi在吗	hizlma
TF家族	tfjwzu
LEEP刀	leepdk
叁K党	sjkdh
短袖T	dwxqt
WiFi	wifi
Hello哦	hellooo
lol盒子	lolhezi
loli控	loliks
AD钙奶	adglnl
Linux	linux
Topshop	topshop
Liekkas	liekkas
LG手机	lgubji
UC迅雷	ucxplz
AUTOCAD	autocad
QQ好友	qqhkyb
Bambook	bambook
Bazinga	bazinga
QQ号	qqhk
QQ飞车	qqfzie
U型管	uxygw
IT行业	itxyye
IT公司	itgssi
QQ拼音	qqpnyn
Islamic	islamic
iReader	ireader
VIP客户	vipkehu
QQ情侣	qqqylv
Windows	windows
WINDOWS	windows
QQ羣	qqqp
H型钢	hxygh
QQ羣号	qqqphk
XP系统	xpxits
Hotwind	hotwind
QQ叁国	qqsjgo
QQ闪图	qqujtu
QQ华夏	qqhwxw
Hotmail	hotmail
X战警	xvjjy
QQ手机	qqubji
Home键	homejw
YouTube	youtube
YY频道	yypndk
high了	highlw
QQ等级	qqdfji
QQ提醒	qqtixy
不登QQ	budfqq
不聊QQ	bulwqq
蹭WiFi	cfwifi
长袖T	ihxqt
超级QQ	ikjiqq
QQ图标	qqtubw
QQ图片	qqtupw
臭baby	ibbaby
Go下载	goxwzl
登录QQ	dfluqq
登你QQ	dfniqq
登我QQ	dfwoqq
QQ微信	qqwzxn
等我QQ	dfwoqq
QQ下载	qqxwzl
豆瓣FM	dbbjfm
GoAgent	goagent
嗯嗯OK	zozook
QQ消息	qqxwxi
果味VC	gowzvc
Foxmail	foxmail
Foxconn	foxconn
QQ旋舞	qqxwwu
很多MM	hfdomm
华数TV	hwuutv
加QQ号	jwqqhk
QQ用户	qqyshu
加QQ羣	jwqqqp
酷我K歌	kuwokge
连WiFi	lwwifi
QQ御剑	qqyujw
联系QQ	lwxiqq
萌小Q	mfxwq
奶茶MM	nliamm
Enemies	enemies
你用QQ	niysqq
AA制	aavi
Dropbox	dropbox
DirectX	directx
Davichi	davichi
QQ登录	qqdflu
深V领	ufvly
手机QQ	ubjiqq
刷QQ币	uwqqbi
QQ联系	qqlwxi
Ctrl键	ctrljw
挺high	tyhigh
Coolpad	coolpad
QQ斗牛	qqdbnq
QQ聊吧	qqlwba
网页QQ	whyeqq
Clannad	clannad
ChoiSin	choisin
我叫MT	wojwmt
我用QQ	woysqq
小baby	xwbaby
小BOSS	xwboss
Camille	camille
小case	xwcase
小loli	xwloli
谢谢LZ	xxxxlz
新版QQ	xnbjqq
Rihanna	rihanna
移动QQ	yidsqq
BT下载	btxwzl
Popstar	popstar
用WiFi	yswifi
POLO衫	polouj
BJD娃娃	bjdwawa
root了	rootlw
在唱K	zlihk
照B超	vkbik
真high	vfhigh
Bigbang	bigbang
O型圈	oxyqw
O型环	oxyhw
Samsung	samsung
over了	overlw
OUTLETS	outlets
周K线	vbkxw
OK了吗	oklwma
OK了啦	oklwla
OK了吧	oklwba
Shimano	shimano
N年前	nnwqw
SimSimi	simsimi
Skyfall	skyfall
Soledad	soledad
sorry啦	sorryla
Monstar	monstar
Sparkey	sparkey
Moncler	moncler
SpeXial	spexial
SQL语句	sqlyuju
Micheal	micheal
Mc白浩	mcblhk
Maybank	maybank
MacBook	macbook
LV包包	lvbkbk
QQ硬盘	qqyypj
AB型血	abxyxt
X染色体	xrjseti
I服了U	ifulwu
C语言	cyuyj
X光片	xgwpw
B细胞	bxibk
QQ彩票	qqclpw
TV动画	tvdshw
QQ相册	qqxwce
QQ校友	qqxwyb
QQ牧场	qqmuih
没登QQ	mzdfqq
就OK了	jqoklw
PP助手	ppvuub
好happy	hkhappy
MAC地址	macdivi
CT检查	ctjwia
QQ影音	qqyyyn
γ刀	γdk
LOGO牆	logoqw
QQ多少	qqdouk
QQ宠物	qqiswu
QQ升级	qqufji
上我QQ	uhwoqq
请加QQ	qyjwqq
QQ水浒	qquvzo
上你QQ	uhniqq
很happy	hfhappy
T细胞	txibk
你上QQ	niuhqq
QQ管家	qqgwjw
QQ在线	qqzlxw
QQ网购	qqwhgb
QQ餐厅	qqcjty
真人CS	vfrfcs
越野e族	ytyeezu
BT种子	btvszi
一上QQ	yiuhqq
PC套件	pctkjw
NBA直播	nbavibo
不上QQ	buuhqq
QQ会员	qqhvyw
GO锁屏	gosopy
我在KTV	wozlktv
我要Q币	woykqbi
GO短信	godwxn
我上QQ	wouhqq
腾讯QQ	tfxpqq
大衆CC	davscc
鄙视ing	biuiing
Y染色体	yrjseti
通过QQ	tsgoqq
芒果TV	mhgotv
WiFi	wifi
IP电话	ipdwhw
双酚A	uwffa
白色T恤	blsetxu
QQ家园	qqjwyw
K歌达人	kgedarf
EMS快递	emskwdi
QQ帐号	qqvhhk
HTC手机	htcubji
FLASHFXP	flashfxp
没上QQ	mzuhqq
Belieber	belieber
QQ表情	qqbwqy
LALABOBO	lalabobo
PS模拟器	psmoniqi
Scofield	scofield
YY小说	yyxwuo
txt下载	txtxwzl
SIM卡	simka
PPTV聚力	pptvjuli
Kimi妈妈	kimimama
GO桌面	govomw
在QQ上	zlqquh
Alemania	alemania
SKINFOOD	skinfood
Skrillex	skrillex
AppStore	appstore
POS机	posji
RMB玩家	rmbwjjw
印花T恤	ynhwtxu
ATM机	atmji
TCL集团	tcljitw
学生MM	xtufmm
信使RNA	xnuirna
Olympics	olympics
Nichkhun	nichkhun
Hongkong	hongkong
FTIsland	ftisland
关联QQ	gwlwqq
QQ名片	qqmypw
VOCALOID	vocaloid
QQ聊天	qqlwtw
HOPE组合	hopezuhe
WiFi密码	wifimima
申请QQ	ufqyqq
NBA新闻	nbaxnwf
QQ签名	qqqwmy
iPad迷你	ipadmini
就上QQ	jquhqq
LadyGaga	ladygaga
QQ软件	qqrwjw
sorry了	sorrylw
ChinaNet	chinanet
QQ申请	qqufqy
Chinaren	chinaren
你OUT了	nioutlw
QQ刷鑽	qquwzw
QQ头像	qqtbxw
ThinkPad	thinkpad
iMessage	imessage
T恤衫	txuuj
Karicare	karicare
SM小说	smxwuo
头文字D	tbwfzid
QQ网名	qqwhmy
lol视频	loluipn
Google	google
东方CJ	dsfhcj
天仙MM	twxwmm
FaceTime	facetime
情侣T恤	qylvtxu
QQ五子棋	qqwuziqi
Facebook	facebook
USB接口	usbjxkb
Michelle	michelle
水木BBS	uvmubbs
魔笛MAGI	modimagi
QQ仙灵	qqxwly
人均GDP	rfjpgdp
McDonald	mcdonald
DNF外挂	dnfwlgw
WhatsApp	whatsapp
Internet	internet
Westlife	westlife
服了you	fulwyou
QQ旋风	qqxwff
QQ邮箱	qqybxw
QQ空间	qqksjw
叁K党	sjkdh
QQ幻想	qqhwxw
baby老婆	babylkpo
手机U盘	ubjiupj
MIC男团	micnjtw
QQ农场	qqnsih
天籁K歌	twzokge
万物high	wjwuhigh
DVD光驱	dvdgwqu
维他命C	wztamyc
维他命E	wztamye
我加你QQ	wojwniqq
QQ输入法	qquurufa
我家WiFi	wojwwifi
我有WiFi	woybwifi
你加我QQ	nijwwoqq
NBA选秀	nbaxwxq
hold不住	holdbuvu
不想say	buxwsay
晚安baby	wjanbaby
休閒T恤	xqxwtxu
KTV包房	ktvbkfh
QQ影像	qqyyxw
WiFi伴侣	wifibjlv
GPS定位	gpsdywz
异维A酸	yiwzasw
GPS导航	gpsdkhh
这麽high	vemehigh
智能ABC	vinfabc
ps教程	psjwif
PPS影音	ppsyyyn
T型台	txytl
WiFi大师	wifidaui
K歌之王	kgeviwh
X射线	xuexw
X射綫	xuexw
短袖T恤	dwxqtxu
哆啦A梦	dolaamf
high起来	highqill
能上QQ	nfuhqq
高达seed	gkdaseed
还上QQ	hwuhqq
阿Q精神	aaqjyuf
QQ降龙	qqjwls
iPhone	iphone
卡拉OK	kalaok
VIP会员	viphvyw
给你发QQ	gznifaqq
JAVA语言	javayuyj
EXO王道	exowhdk
DVD导航	dvddkhh
漂亮MM	pwlwmm
七龙珠Z	qilsvuz
Android	android
CorelDraw	coreldraw
Beautyleg	beautyleg
QQ斗地主	qqdbdivu
DVD光盘	dvdgwpj
WLAN登录	wlandflu
Re管理器	regwliqi
QQ日本版	qqribfbj
Minecraft	minecraft
hi美女好	himznvhk
QQ浏览器	qqzoljqi
长袖T恤	ihxqtxu
你登我QQ	nidfwoqq
PPTV下载	pptvxwzl
没有WiFi	mzybwifi
PSP模拟器	pspmoniqi
MIUI论坛	miuilptj
BigBang的	bigbangde
QuickTime	quicktime
QuickType	quicktype
QQ登录器	qqdfluqi
本多RURU	bfdoruru
Starbucks	starbucks
QQ号码	qqhkma
vivo手机	vivoubji
超级WiFi	ikjiwifi
Linsanity	linsanity
OPPO手机	oppoubji
SATA接口	satajxkb
Flipboard	flipboard
DOS命令	dosmyly
OPPO乐园	oppoleyw
DNS服务器	dnsfuwuqi
iMessages	imessages
english english
IP地址	ipdivi
维生素A	wzufsua
维生素B	wzufsub
维生素C	wzufsuc
叁国Kill	sjgokill
维生素D	wzufsud
Longchamp	longchamp
维生素E	wzufsue
维生素K	wzufsuk
WiFi登录	wifidflu
U形管	uxygw
我用WiFi	woyswifi
FrontPage	frontpage
武侠Q传	wuxwqiw
纯棉T恤	ipmwtxu
YotaPhone	yotaphone
WiFi热点	wifiredw
世界BOSS	uijxboss
圆领T恤	ywlytxu
蓝光DVD	ljgwdvd
Smartisan	smartisan
手机WiFi	ubjiwifi
Nightwish	nightwish
小米Note	xwminote
Instagram	instagram
GIF快手	gifkwub
IE浏览器	iezoljqi
小米WiFi	xwmiwifi
双核CPU	uwhecpu
Panasonic	panasonic
一键root	yijwroot
Ferragamo	ferragamo
移动WiFi	yidswifi
KK唱响	kkihxw
Microsoft	microsoft
Photoshop	photoshop
JJ斗地主	jjdbdivu
唐宁one	thnyone
Yota手机	yotaubji
UC浏览器	uczoljqi
Innisfree	innisfree
WiFi杀手	wifiuaub
长款T恤	ihkwtxu
Miss解说	missjxuo
我上你QQ	wouhniqq
WiFi助手	wifivuub
你上我QQ	niuhwoqq
随身WiFi	svufwifi
QQ网页版	qqwhyebj
SATA硬盘	satayypj
你不上QQ	nibuuhqq
建外SOHO	jwwlsoho
朝外SOHO	ikwlsoho
Hello你好	hellonihk
我不上QQ	wobuuhqq
I服了you	ifulwyou
β粒子	βlizi
FM收音机	fmubynji
沪江小D	hujwxwd
hello在麽	hellozlme
免费WiFi	mwfzwifi
X染色体	xrjseti
叁K党	sjkdh
叁星NOTE	sjxynote
你QQ多少	niqqdouk
Hello美女	hellomznv
Y染色体	yrjseti
阿Q正传	aaqvfiw
IP位址	ipwzvi
WiFi电话	wifidwhw
大宝SOD蜜	dabksodmi
WiFi在线	wifizlxw
Word文档	wordwfdh
MM小游戏	mmxwybxi
WiFi连接	wifilwjx
B超检查	bikjwia
Angelababy	angelababy
RealPlayer	realplayer
NBA季后赛	nbajihbsl
QQ个性网	qqgexywh
OPPO官网	oppogwwh
龙珠Q传	lsvuqiw
免CD补丁	mwcdbudy
α粒子	αlizi
JavaScript	javascript
Hurstville	hurstville
少年JUMP	uknwjump
公交IC卡	gsjwicka
webQQ登录	webqqdflu
水浒Q传	uvzoqiw
CSOL官网	csolgwwh
GooglePlay	googleplay
HelloKitty	hellokitty
IMAX电影	imaxdwyy
Stylenanda	stylenanda
LinkinPark	linkinpark
QQ会员	qqhvyw
IP电话	ipdwhw
OPPO桌面	oppovomw
MPC播放器	mpcbofhqi
CS便携版	csbwxxbj
My盛Lady	myuflady
RunningMan	runningman
ET外星人	etwlxyrf
NIKE官网	nikegwwh
root权限	rootqwxw
我没上QQ	womzuhqq
RH阴性血	rhynxyxt
PowerPoint	powerpoint
QQ轻聊版	qqqylwbj
步步高vivo	bubugkvivo
Google翻译	googlefjyi
WiFi路由器	wifiluybqi
FLASH动画	flashdshw
SOS儿童村	sosertscp
γ射线	γuexw
哆啦A梦	dolaamf
申请QQ号	ufqyqqhk
WiFi共享	wifigsxw
哆啦A梦的	dolaamfde
家的n次方	jwdencifh
我hold不住	woholdbuvu
QQ连连看	qqlwlwkj
QQ电影票	qqdwyypw
江南style	jwnjstyle
Rime	rime
Gmail邮箱	gmailybxw
看哆啦A梦	kjdolaamf
Completedir	completedir
B族维生素	bzuwzufsu
V字仇杀队	vziibuadv
WiFi管理器	wifigwliqi
Q宠大乐斗	qisdaledb
维生素B族	wzufsubzu
QQ仙侠传	qqxwxwiw
β射线	βuexw
LED显示屏	ledxwuipy
阿Q正传	aaqvfiw
QQ透明皮肤	qqtbmypifu
hold不住了	holdbuvulw
α射线	αuexw
登录QQ部落	dfluqqbulo
iPhone锁屏	iphonesopy
智能ABC	vinfabc
齐B小短裙	qibxwdwqp
IP地址查询	ipdiviiaxp
量贩式KTV	lwfjuiktv
Q版泡泡堂	qbjpkpkth
NBA常规赛	nbaihgvsl
QQ主题助手	qqvutivuub
QQ主题管家	qqvutigwjw
造梦西游OL	zkmfxiybol
怎麽不上QQ	zfmebuuhqq
B淋巴细胞	blnbaxibk
T淋巴细胞	tlnbaxibk
QQ网页登录	qqwhyedflu
维生素C片	wzufsucpw
QQ登录网页	qqdfluwhye
SK状元榜	skvwywbh
网页QQ登录	whyeqqdflu
维C银翘片	wzcynqwpw
申请QQ号码	ufqyqqhkma
QQ空间日志	qqksjwrivi
笑傲江湖OL	xwaojwhuol
腾讯QQ登录	tfxpqqdflu
QQ同步助手	qqtsbuvuub
WiFi密码破解	wifimimapojx
QQ在线登录	qqzlxwdflu
txt全集下载	txtqwjixwzl
QQ安全中心	qqanqwvsxn
QQ情侣头像	qqqylvtbxw
掌阅iReader	vhytireader
QQ对战平台	qqdvvjpytl
QQ邮箱登录	qqybxwdflu
QQ网名大全	qqwhmydaqw
QQ个性网名	qqgexywhmy
QQ头像大全	qqtbxwdaqw
QQ空间登录	qqksjwdflu
QQ电脑管家	qqdwnkgwjw
QQ个性签名	qqgexyqwmy
登录QQ邮箱	dfluqqybxw
登录QQ空间	dfluqqksjw
CounterStrike	counterstrike
QQ自由幻想	qqziybhwxw
QQ情侣网名	qqqylvwhmy
QQ聊天背景	qqlwtwbzjy
一键root大师	yijwrootdaui
QQ头像女生	qqtbxwnvuf
搜狗TV输入法	sbgbtvuurufa
百度一键root	blduyijwroot
CF穿越火线	cfiwythoxw
MSN邮箱登录	msnybxwdflu
PPS网络电视	ppswhlodwui
联想Thinkpad	lwxwthinkpad
ES文件浏览器	eswfjwzoljqi
WiFi万能钥匙	wifiwjnfytii
sina邮箱登录	sinaybxwdflu
PPTV网络电视	pptvwhlodwui
QQ空间登录器	qqksjwdfluqi
LINUX操作系统	linuxckzoxits
ABS防抱死系统	absfhbksixits
Gmail邮箱登录	gmailybxwdflu
Yahoo邮箱登录	yahooybxwdflu
WiFi共享精灵	wifigsxwjyly
QQ企业邮箱登录	qqqiyeybxwdflu
QQ家园电脑登录	qqjwywdwnkdflu
QQ邮箱登录首页	qqybxwdfluubye
